Solo	NNP
was	VBD
named	VBN
to	TO
the	DT
U.S.	NNP
women	NNS
's	POS
national	JJ
soccer	NN
team	NN
roster	NN
for	IN
the	DT
post-World	JJ
Cup	NNP
tour	NN
,	,
but	CC
did	VBD
not	RB
attend	VB
the	DT
first	JJ
workout	NN
ahead	RB
of	IN
the	DT
first	JJ
game	NN
against	IN
Mexico	NNP
.	.

On	IN
November	NNP
12	CD
,	,
2012	CD
,	,
Stevens	NNP
was	VBD
arrested	VBN
on	IN
investigation	NN
of	IN
assault	NN
following	VBG
an	DT
altercation	NN
that	WDT
left	VBD
Solo	NNP
injured	VBN
.	.

